transaction_id
TXN0000068
TXN0000099
TXN0000165
TXN0000171
TXN0000205
TXN0000219
TXN0000344
TXN0000491
TXN0000570
TXN0000572
TXN0000583
TXN0000697
TXN0000839
TXN0000840
TXN0000842
TXN0000879
TXN0001033
TXN0001158
TXN0001215
TXN0001258
TXN0001301
TXN0001355
TXN0001448
TXN0001454
TXN0001544
TXN0001550
TXN0001628
TXN0001685
TXN0001778
TXN0001857
TXN0001941
TXN0002051
TXN0002258
TXN0002368
TXN0002385
TXN0002413
TXN0002430
TXN0002431
TXN0002447
TXN0002459
TXN0002489
TXN0002503
TXN0002557
TXN0002585
TXN0002741
TXN0002779
TXN0002783
TXN0002838
TXN0002919
TXN0003020
TXN0003112
TXN0003174
TXN0003249
TXN0003415
TXN0003718
TXN0003874
TXN0003949
TXN0004195
TXN0004298
TXN0004329
TXN0004341
TXN0004642
TXN0004685
TXN0004687
TXN0004721
TXN0004824
TXN0004838
TXN0004840
TXN0004911
TXN0004921
TXN0004927
TXN0004964
TXN0005054
TXN0005067
TXN0005076
TXN0005093
TXN0005098
TXN0005145
TXN0005196
TXN0005228
TXN0005247
TXN0005401
TXN0005532
TXN0005741
TXN0005826
